29
000111000000001000000000000
000000111011110000000000000
111000000000000100000011100
001010000000001000000100000
001011111110010000001000000
001000000000111111111111111
000000000001000000000000000
000000000111000000000000000
000111101100000000000000000
111111111111111111111111111