0000000000000000000
0000000000000000111
1111100000000000000
0000100000111100001
0000111110000000111
0000000000011111000
0000000000000000000
0111100011110011111
0000000110000001111
1111111100001111111