0001110000000010000
0000001110111100111
1110000000000001000
0010100000000010001
0010111111100100111
0010000000001111000
0000000000010000000
0000000001110011111
0001111011000001111
1111111100001111111