0000000000000000000
0000000000000000111
1111100000111100000
0000100000000000001
0000111110000000111
0000000000011111000
0011100000000000000
0000000001110011111
0000000011000001111
1111111100001111111